5	5	6	-1	-1	-1	-1	-1	-1	-1	-1	-1	-1	-1	-1	-1	-1	-1	-1	7	5	5
5	5	6	-1	-1	-1	-1	-1	-1	-1	-1	-1	-1	-1	-1	-1	-1	-1	-1	7	5	5
5	5	6	-1	-1	-1	-1	-1	-1	-1	-1	-1	-1	-1	-1	-1	-1	2	25	8	5	5
5	5	6	-1	-1	-1	-1	-1	-1	-1	-1	-1	-1	-1	-1	-1	-1	11	27	14	5	5
5	5	6	-1	36	38	40	-1	-1	2	1	-1	-1	-1	-1	-1	-1	-1	29	7	5	5
5	5	9	0	37	39	41	0	0	8	9	0	0	0	1	43	2	0	0	8	5	5
5	5	5	5	5	5	5	5	5	5	5	5	5	5	42	44	45	5	5	5	5	5
5	5	5	5	5	5	5	5	5	5	5	5	5	5	5	5	5	5	5	5	5	5
5	5	5	5	5	5	5	5	5	5	5	5	5	5	5	5	5	5	5	5	5	5